1111111111111111111111111111111
10P000C00100000C00000000C100001
100000000100000000000000000E001
1000000000000000C00000000111111
100C000001000000000000000000001
10000000010000000000C0000000001
1000000C0000000C000000000000C01
1111111111111111111111111111111