111111
100001
11P001
11C0E1
111111


